0 0 0 0 0 0 0 0 0 0 0 0 0 0 0 0 0 0 0 0 0 0 0 0 0 0 0 0
0 1 1 1 1 1 1 1 1 1 1 1 1 0 0 1 1 1 1 1 1 1 1 1 1 1 1 0
0 1 0 0 0 0 1 0 0 0 0 0 1 0 0 1 0 0 0 0 0 1 0 0 0 0 1 0
0 2 0 0 0 0 1 0 0 0 0 0 1 0 0 1 0 0 0 0 0 1 0 0 0 0 2 0
0 1 0 0 0 0 1 0 0 0 0 0 1 0 0 1 0 0 0 0 0 1 0 0 0 0 1 0
0 1 1 1 1 1 1 1 1 1 1 1 1 1 1 1 1 1 1 1 1 1 1 1 1 1 1 0
0 1 0 0 0 0 1 0 0 1 0 0 0 0 0 0 0 0 1 0 0 1 0 0 0 0 1 0
0 1 0 0 0 0 1 0 0 1 0 0 0 0 0 0 0 0 1 0 0 1 0 0 0 0 1 0
0 1 1 1 1 1 1 0 0 1 1 1 1 0 0 1 1 1 1 0 0 1 1 1 1 1 1 0
0 0 0 0 0 0 1 0 0 0 0 0 9 0 0 9 0 0 0 0 0 1 0 0 0 0 0 0
0 0 0 0 0 0 1 0 0 0 0 0 9 0 0 9 0 0 0 0 0 1 0 0 0 0 0 0
0 0 0 0 0 0 1 0 0 9 9 9 9 4 9 9 9 9 9 9 9 1 0 0 0 0 0 0
0 0 0 0 0 0 1 0 0 9 0 0 0 9 9 0 0 0 9 0 0 1 0 0 0 0 0 0
0 0 0 0 0 0 1 0 0 9 0 9 9 9 9 9 9 0 9 0 0 1 0 0 0 0 0 0
0 0 0 0 0 0 1 0 0 9 0 9 9 9 9 9 9 0 9 0 0 1 0 0 0 0 0 0
9 9 9 9 9 9 1 9 9 9 0 9 4 9 4 9 4 0 9 9 9 1 9 9 9 9 9 9
0 0 0 0 0 0 1 0 0 9 0 0 0 0 0 0 0 0 9 0 0 1 0 0 0 0 0 0
0 0 0 0 0 0 1 0 0 9 0 0 0 0 0 0 0 0 9 0 0 1 0 0 0 0 0 0
0 0 0 0 0 0 1 0 0 9 9 9 9 9 9 9 9 9 9 0 0 1 0 0 0 0 0 0
0 0 0 0 0 0 1 0 0 9 0 0 0 0 0 0 0 0 9 0 0 1 0 0 0 0 0 0
0 0 0 0 0 0 1 0 0 9 0 0 0 0 0 0 0 0 9 0 0 1 0 0 0 0 0 0
0 1 1 1 1 1 1 1 1 1 1 1 1 0 0 1 1 1 1 1 1 1 1 1 1 1 1 0
0 1 0 0 0 0 1 0 0 0 0 0 1 0 0 1 0 0 0 0 0 1 0 0 0 0 1 0
0 1 0 0 0 0 1 0 0 0 0 0 1 0 0 1 0 0 0 0 0 1 0 0 0 0 1 0
0 2 1 1 0 0 1 1 1 1 1 1 1 1 8 1 1 1 1 1 1 1 0 0 1 1 2 0
0 0 0 1 0 0 1 0 0 1 0 0 0 0 0 0 0 0 1 0 0 1 0 0 1 0 0 0
0 0 0 1 0 0 1 0 0 1 0 0 0 0 0 0 0 0 1 0 0 1 0 0 1 0 0 0
0 1 1 1 1 1 1 0 0 1 1 1 1 0 0 1 1 1 1 0 0 1 1 1 1 1 1 0
0 1 0 0 0 0 0 0 0 0 0 0 1 0 0 1 0 0 0 0 0 0 0 0 0 0 1 0
0 1 0 0 0 0 0 0 0 0 0 0 1 0 0 1 0 0 0 0 0 0 0 0 0 0 1 0
0 1 1 1 1 1 1 1 1 1 1 1 1 1 1 1 1 1 1 1 1 1 1 1 1 1 1 0
0 0 0 0 0 0 0 0 0 0 0 0 0 0 0 0 0 0 0 0 0 0 0 0 0 0 0 0